16,20,
################
#     #    #   #
#     #        #
#     #    #   #
#######    #   #
######## #### ##
#     #    #   #
#     #    #   #
#     #    #   #
#     #    #   #
#     #    #   #
#     #    #   #
#     #    #   #
#     #    #####
#     #    #####
#######    #####
#   #      #####
#          #####
#   #      #####
################
Player,9,7,0
Goal,2,2
KeyDoor,8,5,0,0,255,9,11
KeyDoor,11,2,255,0,0,3,11
KeyDoor,13,5,0,255,0,7,17
TokenDoor,4,17,4
Token,13,9
Token,13,10
Token,13,11
Token,13,12
Teleporter,2,17,4,2
Teleporter,3,13,8,2
FireBoots,13,2
Fire,1,9
Fire,2,9
Fire,3,9
Fire,4,9
Fire,5,9
Flippers,3,7
Water,7,15
Water,8,15
Water,9,15
Water,10,15