15,16,
###############
#       # #   #
# # # ### #   #
# # #     #   #
# # ####  # ###
# #    #  #   #
# # ####      #
# #      ######
# ###  #      #
#      # ## # #
## ### #  # # #
#    # #### # #
#    #      # #
#      # #### #
#    # #      #
###############
Player,2,13,0,
Goal,12,2,
KeyDoor,2,10,Green,2,11,
KeyDoor,5,13,Green,4,13,
SmartEnemy,9,1,2,