12,7,
############
#     #    #
#          #
#          #
#          #
#     #    #
############
Player,9,3,0
Goal,3,3