9,20,
#########
#   #   #
#   #   #
#   #   #
#   #   #
#   #   #
#   ## ##
#   #   #
#   #   #
#   #   #
#   #   #
## ### ##
#       #
#       #
#       #
#       #
#       #
#       #
#       #
#########
Player,4,15,0
Goal,6,3
TokenDoor,2,11,3
TokenDoor,6,6,2
TokenDoor,6,11,4
Token,2,17
Token,3,17
Token,4,17
Token,5,17
Token,6,17
Token,2,3
Token,2,4
Token,2,5
Token,2,6
WallEnemy,1,1,2