13,13,
#############
#     #######
#     #######
#     #######
#     #######
#     #######
### #########
#           #
#           #
#           #
#           #
#           #
#############
Player,3,9,0,
Goal,3,3,
KeyDoor,3,6,Red,9,9,
LineEnemy,6,11,0,