13,13,
#############
#  #        #
#  #        #
#  #        #
#  # ########
#  #        #
#  #   #    #
#  #   #    #
#  #   #    #
#  #   #    #
#  #   #    #
#      #    #
#############
KeyDoor,0,0,0,0,0,2,5
Player,11,3,2
Teleporter,2,11,11,11
KeyDoor,4,4
Fire,8,1
Fire,8,2
Teleporter,11,11,2,11
